{
  lines: [
    '....................',
    '....................',
    '....................',
    '.....1..............',
    '....................',
    '....................',
    '....................',
    '.........GGG........',
    '.........###........',
    '....................',
    '....GGG.......GGG...',
    '....###.......###...',
    '....................',
    '..................X.',
    '####################'
]
}
